GGGGGGGGGGGGGGGGGGGGGGGGAAAAAAGG
GGGGGGGGGGGGGGGGGGGGGGGGAAAAAAGG
GGGGGGGGGGGGAAAAAAAAGGGGAAAAAAGG
GGGGGGGGGGGGAAAAAAAAGGGGAAAAAAGG
GGGGGGGGAAAAAAAAAAAAGGGGAAAAAAGG
GGGGGGGGAAAAAAAAAAAAGGGGAAAAAAGG
GGGGGGAAAAAAAAAAAAAAGGGGAAAAAAGG
GGGGGGAAAAAAAAAAAAAAGGGGAAAAAAGG
GGGGGGAAAAAAAAAAAAAAGGAAAAAAAAGG
GGGGGGAAAAAAAAAAAAAAGGAAAAAAAAGG
GGGGGGAAAAAAAAAAAAAAGGAAAAAAAAGG
GGGGGGAAAAAAAAHHAAAAGGAAAAAAAAGG
GGAAAAAAAAAAAAGGAAAAAAAAAAAAGGGG
GGAAAAAAAAAAAAGGAAAAAAAAAAAAGGGG
GGGGGGGGAAAAAAGGAAAAAAAAAAAAGGGG
GGGGGGGGAAAAAAGGAAAAAAAAAAAAGGGG
GGGGGGGGAAAAAAGGAAAAAAAAAAAAGGGG
GGGGGGGGAAAAAAGGAAAAAAAAAAAAGGGG
GGGGGGGGAAAAAAGGAAAAAAAAAAAAGGGG
GGGGGGGGAAAAAAGGAAAAAAAAAAAAGGGG
GGGGGGGGAAAAAAGGAAAAAAAAAAGGGGGG
GGGGGGGGAAAAAAGGAAAAAAAAAAGGGGGG
GGGGGGGGAAAAAAGGAAAAAAAAAAAAAAGG
GGGGGGGGAAAAAAGGAAAAAAAAAAAAAAGG
AAAAGGGGAAAAAAGGAAAAAAAAAAAAAAGG
AAAAGGGGAAAAAAGGAAAAAAAAAAAAAAGG
AAAAAAGGAAAAAAGGAAAAAAAAAAAAAAGG
AAAAAAGGAAAAAAGGHHHHHHAAAAAAAAAA
AAAAAAAAAAAAAAGGGGGGGGAAAAAAAAAA
AAAAAAAAAAAAAAGGGGGGGGAAAAAAAAAA
GGGGGGGGGGGGGGGGGGGGGGAAAAAAAAAA
GGGGGGGGGGGGGGGGGGGGGGAAAAAAAAAA
