GGGGGGGGGGGGGGGGGGGGGGGAAAAAAGG
GGGGGGGGGGGGGGGGGGGGGGGAAAAAAGG
GGGGGGGGGGGGAAAAAAAGGGGAAAAAAGG
GGGGGGGGGGGGAAAAAAAGGGGAAAAAAGG
GGGGGGGGAAAAAAAAAAAGGGGAAAAAAGG
GGGGGGGGAAAAAAAAAAAGGGGAAAAAAGG
GGGGGGAAAAAAAAAAAAAGGGGAAAAAAGG
GGGGGGAAAAAAAAAAAAAGGGGAAAAAAGG
GGGGGGAAAAAAAAAAAAAGGAAAAAAAAGG
GGGGGGAAAAAAAAAAAAAGGAAAAAAAAGG
GGGGGGAAAAAAAAAAAAAGGAAAAAAAAGG
GGGGGGAAAAAAAHHAAAAGGAAAAAAAAGG
GGAAAAAAAAAAAGGAAAAAAAAAAAAGGGG
GGAAAAAAAAAAAGGAAAAAAAAAAAAGGGG
GGGGGGGGAAAAAGGAAAAAAAAAAAAGGGG
GGGGGGGGAAAAAGGAAAAAAAAAAAAGGGG
GGGGGGGGAAAAAGGAAAAAAAAAAAAGGGG
GGGGGGGGAAAAAGGAAAAAAAAAAAAGGGG
GGGGGGGGAAAAAGGAAAAAAAAAAAAGGGG
GGGGGGGGAAAAAGGAAAAAAAAAAAAGGGG
GGGGGGGGAAAAAGGAAAAAAAAAAGGGGGG
GGGGGGGGAAAAAGGAAAAAAAAAAGGGGGG
GGGGGGGGAAAAAGGAAAAAAAAAAAAAAGG
GGGGGGGGAAAAAGGAAAAAAAAAAAAAAGG
AAAAGGGGAAAAAGGAAAAAAAAAAAAAAGG
AAAAGGGGAAAAAGGAAAAAAAAAAAAAAGG
AAAAAAGGAAAAAGGAAAAAAAAAAAAAAGG
AAAAAAGGAAAAAGGHHHHHHAAAAAAAAAA
AAAAAAAAAAAAAGGGGGGGGAAAAAAAAAA
AAAAAAAAAAAAAGGGGGGGGAAAAAAAAAA
GGGGGGGGGGGGGGGGGGGGGAAAAAAAAAA
GGGGGGGGGGGGGGGGGGGGGAAAAAAAAAA
