GGGGGGGGGGGGGGGGGGGGGGGGGGAAAAGG
GGGGGGGGGGGGGGGGGGGGGGGGGGAAAAGG
GGGGGGGGGGGGGGAAAAAAAAAAAAAAAAGG
GGGGGGGGGGGGGGAAAAAAAAAAAAAAAAGG
GGGGGGGGAAAAAAAAAAAAAAAAAAAAAAGG
GGGGGGGGAAAAAAAAAAAAAAAAAAAAAAGG
GGGGGGAAAAAAAAAAAAAAAAAAAAGGGGGG
GGGGGGAAAAAAAAAAAAAAAAAAAAGGGGGG
GGGGGGAAAAAAAAAAAAAAAAAAGGGGGGGG
GGGGGGAAAAAAAAAAAAAAAAAAGGGGGGGG
GGGGGGAAAAAAAAAAAAAAAAAAAAAAGGGG
GGGGGGAAAAAAAAAAAAAAAAAAAAAAGGGG
GGGGGGGGGGAAAAAAAAAAAAAAAAAAAAGG
GGGGGGGGGGAAAAAAAAAAAAAAAAAAAAGG
GGGGAAAAAAAAAAAAAAAAAAAAAAAAAAGG
GGGGAAAAAAAAAAAAAAAAAAAAAAAAAAGG
GGAAAAAAAAAAAAAAAAAAAAAAAAAAAAGG
GGAAAAAAAAAAAAAAAAAAAAAAAAAAAAGG
GGAAAAAAAAAAAAAAAAAAAAAAAAGGGGGG
GGAAAAAAAAAAAAAAAAAAAAAAAAGGGGGG
AAAAAAAAAAAAAAAAAAAAAAAAAAAAGGGG
AAAAAAAAAAAAAAAAAAAAAAAAAAAAGGGG
AAAAAAAAAAAAAAGGGGAAAAAAAAAAGGGG
AAAAAAAAAAAAAAGGGGAAAAAAAAAAGGGG
AAAAAAGGGGAAAAGGGGAAAAAAAAAAGGGG
AAAAAAGGGGAAAAGGGGAAAAHHHHHHGGGG
GGGGGGGGGGAAAAGGGGAAAAGGGGGGGGGG
GGGGGGGGGGAAAAGGGGHHHHGGGGGGGGGG
GGGGGGGGGGAAAAGGGGGGGGGGGGGGGGGG
GGGGGGGGGHHHHHGGGGGGGGGGGGGGGGGG
GGGGGGGGGGGGGGGGGGGGGGGGGGGGGGGG
GGGGGGGGGGGGGGGGGGGGGGGGGGGGGGGG
